[header]
width=13
height=7

[layer]
type=Tile Layer 1
data=
1,1,1,1,1,1,1,1,1,1,1,1,1,
1,57,57,57,57,57,57,57,57,57,57,57,1,
1,57,57,57,57,57,57,57,57,57,57,57,1,
1,57,57,57,57,57,57,57,57,57,57,57,1,
1,57,57,57,57,57,57,57,57,57,57,57,1,
1,57,57,57,57,57,57,57,57,57,57,57,1,
1,1,1,1,1,1,1,1,1,1,1,1,1

